                                                   
                                         IIIIIIIII 
                   BBBBBBBBBBBBB;;;BBBBB IIIIIIIII 
                   BB;;BBBBBBBBBBBBBBBBB IIIIIIIII 
IIIIIIIIIIIIIIIIII BBBBBBBBBBBBBBBBBBBBB IIIIISIII 
IIIIIIIIIIIIIIIIII B;;;;;;;;;BBBBBBBBBBB IIIIIIIII 
IIIIIIIIIIIIIIIIII                       IIIIIIIII 
IIIIIIIIIIIIIIIIIIIIIIIIIIIIIIIIIIIIIIIIIIIIIIIIII 
IIIIIIIIIIIIIIIIIIIIIIIIIIIIIIIIIIIIIIIIIIIIIIIIII 
                   IIIIIIIIIIIIIIII                
 IIIIIIIIIIIIIIIII IIIISIIIIIIIIIIIIIIIIIIIIIIISII 
 IIISIIIIIISSIIIII IIIIIIIIIIIIIIIIIIIIIIIIIIIIIII 
 IIIIIIIIIISIIIIII IIIIIIIIIIIIIIIIIIIIIIIISIIIIII 
        II         IIIIIIIIIIIIIIIIIIIIIIIIIIIIIII 
 IIIISIIIIIIIIIIII IIIIIIIIIISIIIIIIIIIISIIIIIIIII 
 IIIIIIIISIIIIIIII IIISIIIIIIIIIIII IIIIIIIIIIIIII 
 IIIIISIIIIIISIIII IIIIIIIIIIIIIIII IIIIIIIIIIIIII 
 IIIIIIIIIIIIIIIII         III                     
 IIIISIIISIIIIIIIIIIIIIIIIIIIIIIIIIIIIIIIIIIIIIIII 
 IIIIIIIIIIIIIIIISIIIISIIIIIIIIIIIIIIIIIIIIIIIIIII 
                                                   
