                  XHHHHHHHHHHHHHHHHHHHHHXXXXXXXXXXX
                  XGGGGGGGGGGGGGGGGGGGGGXXXXXXXXXXX
FFFFFFFFFFFFFFFFFFXXXXXXXXXXXXXXXXXXXXXXXXXXXXXXXXX
EEEEEEEEEEEEEEEEEEXXXXXXXXXXXXXXXXXXXXXXXXXXXXXXXXX
XXBXXBXXBXXBXXXXXXXXXXXXXXXXXXXXXXXXXXXXXXXXXXXXXXX
XXXXXXXXXXXXXXXXXXHHHHHHHHHHHHHHHHHHHHHHGXXXXXXXXXX
XXBXXBXXBXXBXXXXXXGGGGGGGGGGGGGGGGGGGGGGGXXXXXXXXXX
XXXXXXXXXXXXXXXXXXXXXXXXXXXXXXXXXXXXXXXXXXXXXXXXXXX
FFFFFFFFFFFFFFFFFFXXXXXXXXXXXXXXXXXFFFFFFFFFFFFFFFF
EEEEEEEEEEEEEEEEEEXXXXXXXXXXXXXXXXXEEEEEEEEEEEEEEEE
XXXXXXXXXXXXXXXXXXXXXXXXXXXXXXXXXXXXXXXXXXXXXXXXXXX
XXXXXXXXXXXXXXXXXXXXXXXXXXXXXXXXXXXXXXXXXXXXXXXXXXX
FFFFFFFFXXFFFFFFFFXXXXXXXXXXXXXXXXXXXXXXXXXXXXXXXXX
EEEEEEEEXXEEEEEEEEXXXXXXXXXXXXXXXXXXXXXXXXXXXXXXXXX
XXXXXXXXXXXXXXXXXXXXXXXXXXXXXXXXXXXXXXXXXXXXXXXXXXX
XXXXXXXXXXXXXXXXXXXXXXXXXXXXXXXXXXXXXXXXXXXXXXXXXXX
XXXXXXXXXXXXXXXXXXFFFFFFFFFXXXFFFFFXFFFFFFFFFFFFFFX
XXXXXXXXXXXXXXXXXXEEEEEEEEEXXXEEEEEXEEEEEEEEEEEEEEX
XXXXXXXXXXXXXXXXXXXXXXXXXXXXXXXXXXXXXXXXXXXXXXXXXXX
XXXXXXXXXXXXXXXXXXXXXXXXXXXXXXXXXXXXXXXXXXXXXXXXXXX
XXXXXXXXXXXXXXXXXXXXXXXXXXXXXXXXXXXXXXXXXXXXXXXXXXX
